jó=good
jól=good
rosszul=sick
igen=yes
nem=no
vagy=you are
vagyok=i am
reggel=morning
dél=midday, noon
délután=afternoon
esté=evening
éjszaká=night 
szívesen=you're welcome
köszönöm=thank you
viszlát=good bye
nagyon=very
szépen=nicely
menj=go
viszontlátásra=goodbye
oda=there
sajnos=unfortunately
bocs=sorry
elnézést=excuse me
menni=go
nincs=he does not
kérek=please
ide=(to) here
oda=(or) there
hány=how many
év=year
sör=beer
vizer=water
kérni=want
szeretnék=i would like
bort=wine
akarok=i want
lámpa=lanp
alma=apple
lány=girl
fiú=boy
egy=a/an/one
és=and
autó=car
telefon=telephone
szék=chair
asztal=table
ablak=window
férfi=man
nő=woman
van=is
hol van=where
kint=outside
bent=inside
itt=here
ott=there
ő=he/she
mi=what
vonat=train
busz=bus
meg=and, whereas
hanem=but, rather
fent=above, up there, upstairs
lent=below, down there, downstairs
elöl=in the front, 
hátul=at the back, behind
gyakran=often
mindig=always
ritkán=rarely
soha=never
tűz=fire
otthon=at home
álom=dream
Eśő=rain
hó=snow
jég=ice
viszontlátásra=goodbye
elnézést=excuse me
menj=Go
bocsánat=I am sorry
szeretnék kérni=I'd like (smth) please
kérek=want
mi=what
nev=name
neved=your name
hívnak=name
hív=to call
ház=house
óra=clock
fekete=black
piros=red
kicsi=small
nagy=big
alacsony=short
magas=tall